20 20 125
X.....XXXXXXX.D.....
X...H...XXXXXXXXX...
XXX........XX.......
XXXXXXXXX..XX..XXXXX
XX..................
X.........XX..X..X..
.....XXXXXXX........
..XXXX...E.X....XX..
.....X..XXXX....XX..
.....X....XX........
.....XXX..XX...X...X
....................
....X....XX......XX.
....X.....XX........
....X......XXXXXXX..
....X......XX...XX..
..XXXXXX.X.XX.K.XX..
....X......XX...XX..
...........XX...XX..
XX.e.XX.............